$$$ exec p2: [players/superjeannot.filler]
Plateau 15 17:
000 ....O............
001 OOOOOO...........
002 ....O............
003 ....OOO.O........
004 ....O.OOO........
005 O..OO..O.........
  6 OO..O..OO........
  7 OOO.O...O........
  8 OOOOOO...........
  9 ....O............
 10 ....OO.XX........
 11 ........XXXXXX...
 12 .............XX..
 13 ..............X..
 14 ..............X..
 end
